

   

C 35,206,10
F 116 , 0  ,10
NO /Users/ael-oual/Desktop/cub3d/Cub3d/sprites/xpm_images/east ok.xpm
SO /Users/ael-oual/Desktop/cub3d/Cub3d/sprites/xpm_images/north.xpm
WE /Users/ael-oual/Desktop/cub3d/Cub3d/sprites/xpm_images/south.xpm        
EA /Users/ael-oual/Desktop/cub3d/Cub3d/sprites/xpm_images/west.xpm




111111111                       
1111011111
100001111  
111N11111
111111111



















